3 1 239 863 118 15 1 7
3 1 239 863 118 15 2 7
3 2 335 895 147 14 2 7
3 2 335 895 147 14 3 7
3 3 1048 768 69 16 6 6
3 4 904 831 213 16 5 6
3 4 904 831 213 16 5 7
3 4 904 831 213 16 6 6
3 4 904 831 213 16 6 7
3 5 1409 927 80 15 8 7
3 5 1409 927 80 15 9 7
3 6 1425 863 64 15 8 7
3 6 1425 863 64 15 9 7
3 7 1321 816 101 14 8 6
3 8 1242 752 156 16 7 6
3 8 1242 752 156 16 8 6
3 9 311 370 125 15 1 3
3 9 311 370 125 15 2 3
3 10 256 274 131 15 1 2
3 10 256 274 131 15 2 2
3 11 360 226 108 16 2 1
3 11 360 226 108 16 2 2
3 12 616 417 108 15 3 3
3 12 616 417 108 15 4 3
3 13 871 513 101 16 5 4
3 13 871 513 101 16 6 4
3 14 944 449 165 16 5 3
3 14 944 449 165 16 6 3
3 15 856 322 45 15 5 2
3 16 928 274 191 16 5 2
3 16 928 274 191 16 6 2
3 17 1392 609 97 16 8 5
3 17 1392 609 97 16 9 5
3 18 1305 258 109 16 8 2
3 19 1385 211 173 15 8 1
3 19 1385 211 173 15 9 1
3 20 1570 975 252 15 9 8
3 20 1570 975 252 15 10 8
3 20 1570 975 252 15 11 8
3 21 1637 768 185 15 10 6
3 21 1637 768 185 15 11 6
3 22 1570 719 108 16 9 5
3 22 1570 719 108 16 9 6
3 22 1570 719 108 16 10 5
3 22 1570 719 108 16 10 6
3 26 1570 608 60 16 9 5
3 26 1570 608 60 16 10 5
3 27 1617 528 181 16 10 4
3 27 1617 528 181 16 11 4
3 28 2180 815 92 16 13 6
3 28 2180 815 92 16 14 6
3 29 2146 704 126 16 13 5
3 29 2146 704 126 16 13 6
3 29 2146 704 126 16 14 5
3 29 2146 704 126 16 14 6
3 30 2034 449 238 16 12 3
3 30 2034 449 238 16 13 3
3 30 2034 449 238 16 14 3
3 31 1873 242 261 15 11 2
3 31 1873 242 261 15 12 2
3 31 1873 242 261 15 13 2
5 32 129 752 126 6 0 6
5 32 129 752 126 6 1 6
5 33 0 704 143 7 0 5
5 34 128 553 144 7 0 4
5 34 128 553 144 7 1 4
5 35 0 498 103 7 0 4
5 36 144 355 119 6 0 2
5 36 144 355 119 6 0 3
5 36 144 355 119 6 1 2
5 36 144 355 119 6 1 3
5 37 0 291 104 7 0 2
5 39 128 235 143 7 0 1
5 39 128 235 143 7 0 2
5 39 128 235 143 7 1 1
5 39 128 235 143 7 1 2
5 40 449 911 368 7 2 7
5 40 449 911 368 7 3 7
5 40 449 911 368 7 4 7
5 40 449 911 368 7 5 7
5 41 425 816 192 7 2 6
5 41 425 816 192 7 3 6
5 43 762 737 55 6 4 6
5 43 762 737 55 6 5 6
5 42 450 704 334 7 2 5
5 42 450 704 334 7 3 5
5 42 450 704 334 7 4 5
5 44 546 586 271 6 3 4
5 44 546 586 271 6 4 4
5 44 546 586 271 6 5 4
5 45 426 458 215 6 2 3
5 45 426 458 215 6 3 3
5 45 426 458 215 6 4 3
5 46 442 290 118 7 2 2
5 46 442 290 118 7 3 2
5 47 849 912 87 6 5 7
5 48 849 737 40 6 5 6
5 49 865 705 96 6 5 5
5 49 865 705 96 6 6 5
5 50 945 672 64 7 5 5
5 50 945 672 64 7 6 5
5 51 849 585 64 7 5 4
5 52 707 370 85 7 4 3
5 53 770 338 140 7 4 2
5 53 770 338 140 7 5 2
5 54 849 315 104 6 5 2
5 55 769 219 144 7 4 1
5 55 769 219 144 7 5 1
5 56 1114 911 118 7 6 7
5 56 1114 911 118 7 7 7
5 57 1115 688 165 7 6 5
5 57 1115 688 165 7 7 5
5 57 1115 688 165 7 8 5
5 58 1065 481 169 7 6 4
5 58 1065 481 169 7 7 4
5 59 1121 322 144 7 7 2
5 60 1099 211 165 7 6 1
5 60 1099 211 165 7 7 1
5 61 1233 370 496 7 7 3
5 61 1233 370 496 7 8 3
5 61 1233 370 496 7 9 3
5 61 1233 370 496 7 10 3
5 62 1786 1023 182 7 11 8
5 62 1786 1023 182 7 12 8
5 64 1850 848 88 7 11 7
5 64 1850 848 88 7 12 7
5 65 1770 609 184 7 11 5
5 65 1770 609 184 7 12 5
5 66 1794 370 160 7 11 3
5 66 1794 370 160 7 12 3
5 67 2091 593 181 7 13 4
5 67 2091 593 181 7 13 5
5 67 2091 593 181 7 14 4
5 67 2091 593 181 7 14 5
5 68 2082 212 190 6 13 1
5 68 2082 212 190 6 14 1
8 71 0 1100 2272 20 0 9
8 71 0 1100 2272 20 1 9
8 71 0 1100 2272 20 2 9
8 71 0 1100 2272 20 3 9
8 71 0 1100 2272 20 4 9
8 71 0 1100 2272 20 5 9
8 71 0 1100 2272 20 6 9
8 71 0 1100 2272 20 7 9
8 71 0 1100 2272 20 8 9
8 71 0 1100 2272 20 9 9
8 71 0 1100 2272 20 10 9
8 71 0 1100 2272 20 11 9
8 71 0 1100 2272 20 12 9
8 71 0 1100 2272 20 13 9
8 71 0 1100 2272 20 14 9
6 69 1489 402 81 718 9 3
6 69 1489 402 81 718 9 4
6 69 1489 402 81 718 9 5
6 69 1489 402 81 718 9 6
6 69 1489 402 81 718 9 7
6 69 1489 402 81 718 9 8
6 69 1489 402 81 718 9 9
